Full Name	First Name	Last Name
Laura Crotty Alexander	Laura	Crotty Alexander
Sanjay Nigam	Sanjay	Nigam
Louise Laurent	Louise	Laurent
Lars Bode	Lars	Bode
Gabriel Haddad	Gabriel	Haddad
Suzi Hong	Suzi	Hong
Rohit Loomba	Rohit	Loomba
Kyung Rhee	Kyung	Rhee
Vipin Kumar	Vipin	Kumar
Peter Ernst	Peter	Ernst
Douglas Conrad	Douglas	Conrad
Pieter Dorrestein	Pieter	Dorrestein
Paul Jensen	Paul	Jensen
Rob Knight	Rob	Knight
Victor Nizet	Victor	Nizet
Bill Sandborn	Bill	Sandborn
Karsten Zengler	Karsten	Zengler
Manuela Raffatellu	Manuela	Raffatellu
Brigid Boland	Brigid	Boland
Abraham Palmer	Abraham	Palmer
Sheila Podell	Sheila	Podell
Jennifer Smith	Jennifer	Smith
Michael McCarthy	Michael	McCarthy
Shane Crotty	Shane	Crotty
Wenxian Fu	Wenxian	Fu
Matt Daugherty	Matt	Daugherty
Adam DeConde	Adam	DeConde
Rommie E. Amaro	Rommie E.	Amaro
Kit Pogliano	Kit	Pogliano
Sandip Patel	Sandip	Patel
John Bradley	John	Bradley
Emily Lukacz	Emily	Lukacz
Lisa Eyler	Lisa	Eyler
Chris Glass	Chris	Glass
Maria Rosario Araneta	Maria Rosario	Araneta
Pascal Gagneux	Pascal	Gagneux
Lada Rasochova	Lada	Rasochova
Shelley Lawrence	Shelley	Lawrence
Jim Moore	Jim	Moore
Jill Mesirov	Jill	Mesirov
Sheila Crowe	Sheila	Crowe
Wayne Pfeiffer	Wayne	Pfeiffer
Lakshmi Chilukuri	Lakshmi	Chilukuri
James Golden	James	Golden
Lihini Aluwihare	Lihini	Aluwihare
Scott Baden	Scott	Baden
Nan Hao	Nan	Hao
Justin Meyer	Justin	Meyer
Joseph Vinetz	Joseph	Vinetz
Bernd Schnabl	Bernd	Schnabl
Siavash Mirarab	Siavash	Mirarab
Amir Zarrinpar	Amir	Zarrinpar
Mohit Jain	Mohit	Jain
Ilkay Altintas	Ilkay	Altintas
David Smith	David	Smith
Nick Webster	Nick	Webster
Martin Paulus	Martin	Paulus
Prashant Mali	Prashant	Mali
Brinda Rana	Brinda	Rana
Douglas Bartlett	Douglas	Bartlett
James McKerrow	James	McKerrow
Carolyn Kurle	Carolyn	Kurle
Marygorret Obonyo	Marygorret	Obonyo
Lena Gerwick	Lena	Gerwick
David Pride	David	Pride
Kumud Singh	Kumud	Singh
Kumar Sharma	Kumar	Sharma
Hayat Mousa	Hayat	Mousa
Varykina Thackray	Varykina	Thackray
Susan Golden	Susan	Golden
Michael Matthias	Michael	Matthias
Stephen Mayfield	Stephen	Mayfield
Robert Mak	Robert	Mak
Scott Lippman	Scott	Lippman
Christian Metallo	Christian	Metallo
Brian Palenik	Brian	Palenik
Joseph Wang	Joseph	Wang
Eric Allen	Eric	Allen
Michael Karin	Michael	Karin
Stephanie Fraley	Stephanie	Fraley
Ken Kreutz-Delgado	Ken	Kreutz-Delgado
Kevin Patrick	Kevin	Patrick
Shankar Subramaniam	Shankar	Subramaniam
Jules Jaffe	Jules	Jaffe
Anthony O'Donoghue	Anthony	O'Donoghue
Bradley Moore	Bradley	Moore
Pam Taub	Pam	Taub
Cheryl Anderson	Cheryl	Anderson
Richard Gallo	Richard	Gallo
Jesus Rivera-Nieves	Jesus	Rivera-Nieves
William Fenical	William	Fenical
Partho Ghosh	Partho	Ghosh
Nuno Bandeira	Nuno	Bandeira
Gary Firestein	Gary	Firestein
Alisa Huffaker	Alisa	Huffaker
Jacqueline Kerr	Jacqueline	Kerr
Robert Heaton	Robert	Heaton
Eric Schmelz	Eric	Schmelz
Oliver Ryder	Oliver	Ryder
George Perdrizet	George	Perdrizet
Donald Durden	Donald	Durden
John Chang	John	Chang
Gordon Saxe	Gordon	Saxe
Sheldon Brown	Sheldon	Brown
Kun Zhang	Kun	Zhang
Kimberly Prather	Kimberly	Prather
David Gonzalez	David	Gonzalez
Sergey Kryazhimskiy	Sergey	Kryazhimskiy
Jerrold Olefsky	Jerrold	Olefsky
Cinnamon Bloss	Cinnamon	Bloss
Emily Troemel	Emily	Troemel
Ming Tsuang	Ming	Tsuang
Gurol Suel	Gurol	Suel
Dilip Jeste	Dilip	Jeste
Lawrence Prince	Lawrence	Prince
Ajit Varki	Ajit	Varki
Ethan Bier	Ethan	Bier
Jane Burns	Jane	Burns
Nadir Weibel	Nadir	Weibel
Sara Browne	Sara	Browne
Li-Fan Lu	Li-Fan	Lu
Todd Coleman	Todd	Coleman
Julie Ryu	Julie	Ryu
Terry Hwa	Terry	Hwa
Dorothy Sears	Dorothy	Sears
Rachel Dutton	Rachel	Dutton
Vineet Bafna	Vineet	Bafna
Bernhard Palsson	Bernhard	Palsson
Pavel Pevzner	Pavel	Pevzner
Larry Smarr	Larry	Smarr
Jeff Hasty	Jeff	Hasty
Jack Gilbert	Jack	Gilbert
Chun-Nan Hsu	Chun-Nan	Hsu
Jeff Bowman	Jeff	Bowman
Linda Brubaker	Linda	Brubaker
Jonathan Shurin	Jonathan	Shurin
Sheng Zhong	Sheng	Zhong
Anna Di Nardo	Anna	Di Nardo
Kim Barrett	Kim	Barrett
Michael Kurisu	Michael	Kurisu
Glenn Tesler	Glenn	Tesler
Trey Ideker	Trey	Ideker
		
		
		
		
		
		
		
		
		
		
		
		
		
		
		
		
		
		
		
		
		
		
		
		
		
		
		
		
		
		
		
		
		
		
		
		
		
		
		
		
		
		
		
		
		
		
		
		
		
		
		
		
		
		
		
		
		
		
		
		
		
		
		
		
		
		
		
		
		
		
		
		
		
		
		
		
		
		
		
		
		
		
		
		
		
		
		
		
		
		
		
		
		
		
		
		
		
		
		
		
		
		
		
		
		
		
		
		
		
		
		
		
		
		
		
		
		
		
		
		
		
		
		
		
		
		
		
		
		
		
		
		
		
		
		
		
		
		
		
		
		
		
		
		
		
		
		
		
		
		
		
		
		
		
		
		
		
		
		
		
		
		
		
		
		
		
		
		
		
		
		
		
		
		
		
		
		
		
		
		
		
		
		
		
		
		
		
		
		
		
		
		
		
		
		
		
		
		
		
		
		
		
		
		
		
		
		
		
		
		
		
		
		
		
		
		
		
		
		
		
		
		
		
		
		
		
		
		
		
		
		
		
		
		
		
		
		
		
		
		
		
		
		
		
		
		
		
		
		
		
		
		
		
		
		
		
		
		
		
		
		
		
		
		
		
		
		
		
		
		
		
		
		
		
		
		
		
		
		
		
		
		
		
		
		
		
		
		
		
		
		
		
		
		
		
		
		
		
		
		
		
		
		
		
		
		
		
		
		
		
		
		
		
		
		
		
		
		
		
		
		
		
		
		
		
		
		
		
		
		
		
		
		
		
		
		
		
		
		
		
		
		
		
		
		
		
		
		
		
		
		
		
		
		
		
		
		
		
		
		
		
		
		
		
		
		
		
		
		
		
		
		
		
		
		
		
		
		
		
		
		
		
		
		
		
		
		
		
		
		
		
		
		
		
		
		
		
		
		
		
		
		
		
		
		
		
		
		
		
		
		
		
		
		
		
		
		
		
		
		
		
		
		
		
		
		
		
		
		
		
		
		
		
		
		
		
		
		
		
		
		
		
		
		
		
		
		
		
		
		
		
		
		
		
		
		
		
		
		
		
		
		
		
		
		
		
		
		
		
		
		
		
		
		
		
		
		
		
		
		
		
		
		
		
		
		
		
		
		
		
		
		
		
		
		
		
		
		
		
		
		
		
		
		
		
		
		
		
		
		
		
		
		
		
		
		
		
		
		
		
		
		
		
		
		
		
		
		
		
		
		
		
		
		
		
		
		
		
		
		
		
		
		
		
		
		
		
		
		
		
		
		
		
		
		
		
		
		
		
		
		
		
		
		
		
		
		
		
		
		
		
		
		
		
		
		
		
		
		
		
		
		
		
		
		
		
		
		
		
		
		
		
		
		
		
		
		
		
		
		
		
		
		
		
		
		
		
		
		
		
		
		
		
		
		
		
		
		
		
		
		
		
		
		
		
		
		
		
		
		
		
		
		
		
		
		
		
		
		
		
		
		
		
		
		
		
		
		
		
		
		
		
		
		
		
		
		
		
		
		
		
		
		
		
		
		
		
		
		
		
		
		
		
		
		
		
		
		
		
		
		
		
		
		
		
		
		
		
		
		
		
		
		
		
		
		
		
		
		
		
		
		
		
		
		
		
		
		
		
		
		
		
		
		
		
		
		
		
		
		
		
		
		
		
		
		
		
		
		
		
		
		
		
		
		
		
		
		
		
		
		
		
		
		
		
		
		
		
		
		
		
		
		
		
		
		
		
		
		
		
		
		
		
		
		
		
		
		
		
		
		
		
		
		
		
		
		
		
		
		
		
		
		
		
		
		
		
		
		
		
		
		
		
		
		
		
		
		
		
		
		
		
		
		
		
		
		
		
		
		
		
		
		
		
		
		
		
		
		
		
		
		
		
		
		
		
		
		
		
		
		
		
		
		
		
		
		
		
		
		
		
		
		
		
		
		
		
		
		
		
		
		
		
		
		
		
		
